Stack Kingdom
An Interactive Fiction by The Open Up Team
Release 1 / Serial number 220913 / Inform 7 build 6M62 (I6/v6.33 lib 6/12N) SD

The Red Mountaintop
You are at the summit at the top of the magical Red Mountain, home of the Red Wizard. You feel a strong presence of energy beneath your feet.

>look
The Red Mountaintop
You are at the summit at the top of the magical Red Mountain, home of the Red Wizard. You feel a strong presence of energy beneath your feet.

>look around
You can't see any such thing.

>go north
RedMountainPass

>look
RedMountainPass

>go south
RedMountaintop

>go south
You can't go that way.

>go north
RedMountainPass

>go north
You can't go that way.